Article Title	Description	Coding
Hunger Games prequel sings an edgier tune in ‘Songbirds & Snakes’	Fifth film in the dystopian sci-fi franchise is supposed to be bloody and brutal, and it is.	\s
‘The Marvels’ Faces Anti-‘Woke’ Backlash After Box Office Flop—Echoing ‘Captain Marvel’ Attacks	Both “The Marvels” and “Captain Marvel” star Oscar winner Brie Larson, who has faced sexist attacks for comments she has made pushing for diversity in Hollywood and film criticism.	\s
‘The Marvels’ Director Tackles Anti-Woke MCU Fans	In a recent interview, The Marvels (2023) director Nia DaCosta addressed the anti-woke backlash to the film and how she deals with the toxic parts of the Marvel fan base. The sequel to Captain Marvel (2019), The Marvels follows Captain Marvel/Carol Danvers (B…	\s
THE MARVELS Reportedly Cut A Scene Confirming Carol Danvers And Valkyrie Were In A Relationship	Some details on several scenes that were reportedly cut from The Marvels have been revealed, and it seems the sequel originally made it clear that Carol Danvers and Valkyrie were in a relationship.	\s
Emerald Fennell’s Poisoned Fantasies	The director is building a world of brutality and Millennial vibes, one movie at a time.	\s
Which Documentary Honors Provide the Best Preview for the Best Documentary Feature Race	With the first round of major winter award nominations in tow, "Screen Talk" host Anne Thompson explains how organizations like Doc NYC affect the Best Documentary Feature Oscar race.	\s
‘Saltburn’ Composer Anthony Willis On Emerald Fennell’s “Dirty Sense” And Templar Knights – Sound & Screen Film	It wasn’t a tough decision for Anthony Willis when Emerald Fennell asked him to compose Saltburn, the drama that stars Barry Keoghan as a young and nerdy Oxford university student who becomes obsessed with a popular and wealthy student (Jacob Elordi). Willis …	\s
IndieWire 2023 Gift Guide: 23 Perfect Holiday Gift Ideas for Cinephiles, TV Fans, and Aspiring Filmmakers	From "Barbie" rollerblades and "White Lotus" sweater vests to Moment iPhone camera lenses and Celluloid the Card Game, IndieWire staffers share the presents they'd like to give and receive this holiday season.	\s
The MCU Is in Big Trouble — Can These Modest Ideas Help the Massive Franchise Get Back on Track?	Six IndieWire staffers of various levels of MCU fandom and interest offer up their ideas for restoring the blockbuster behemoth to its former glory — or at least make it actually interesting.	\s
‘The Holdovers’ Director Alexander Payne Weighs In on AI, Working With Paul Giamatti and Returning to His Greek Roots in Thessaloniki	Hollywood might have ground to a halt in recent months during the recent labor strikes, with the role of artificial intelligence in the moviemaking business a key stumbling block between studio bosses and both the writers and actors guilds. But two-time Acade…	\s
Sweet Nothings: On the Emptiness of Sofia Coppola’s Priscilla	At the conclusion of Priscilla Beaulieu Presley’s 1985 memoir, Elvis and Me, she writes that Elvis “was, and remains, the greatest influence in my life.” Priscilla’s formative years with the King of Rock and Roll are what constitute much of her plainspoken ye…	\s
‘Hunger Games: Ballad of Songbirds and Snakes’ Earns $5.75 Million at Thursday Box Office	"Trolls Band Together" earned $1.3 million in preview showings while "Thanksgiving" carved up $1 million
The post ‘Hunger Games: Ballad of Songbirds and Snakes’ Earns $5.75 Million at Thursday Box Office appeared first on TheWrap.	\s
‘Priscilla’, ‘The Holdovers’ Expand Nicely; ‘Dream Scenario’ With Nicolas Cage Sees Solid Limited Opening – Specialty Box Office	Festival and specialty fare releases crowded the top ten this weekend with Priscilla (A24) and The Holdovers (Focus Features) expanding to hit nos. 4 and 6 respectively. Yash Raj Films’ Bollywood thriller Tiger 3 is at no. 8, and world of mouth continued to b…	\s
The Best Bang for Your Buck Events in Portland This Weekend: Nov 10–12, 2023	Desi Diwali Dance Party, Gobble Up Portland, and More Cheap & Easy Events Under $15
 
 by EverOut Staff
 
 
 
 Whether or not you have a long weekend, we're sharing a wealth of well-advised ways to spend it, with events from Gobble Up Portland to Drawn Hungry…	\s
Miramax Loved ‘The Holdovers’ ’70s-Style Logo Design So Much It Ended Up Using It on Other Releases	Director Alexander Payne’s “The Holdovers” roots itself in 1970s nostalgia, right down to the main title design and the studio logos. However, neither company existed at the time. Distributor Focus Features was founded in 2002, while the film’s production com…	\s
‘Hunger Games’ prequel tops box office, 'Trolls Band Together' opens in 2nd place	“The Hunger Games: The Ballad of Songbirds & Snakes” tops the North American box office in its first weekend in theaters	\s
'Thanksgiving' Helps Bring The Jump Scare Back To The Box Office	Director Eli Roth’s new horror movie is inane, gory, rife with stereotypes, but oh-so-fun for fans looking to be both terrified and repulsed at the theater.	\s
Most Anticipated Horror Movies Coming Out In 2023 & Beyond	What are the best and most anticipated horror movies coming out in 2023, 2024, and beyond? There’s no shortage of scary films over the next few years, as we see the return of terrifying series such as A Quiet Place and Alien, along with new work from director…	\s
The Ballad Of Songbirds & Snakes: Rachel Zegler On Lucy Gray's Fate	The book that The Hunger Games: The Ballad Of Songbirds & Snakes is based on has been out since late 2020, but plenty of people haven't read the book but have every intention of seeing the movie. Star Rachel Zegler has shared her opinion on the ending her cha…	\s
‘Priscilla’ Shines A Darker Light On The King of Rock N Roll	Elvis Presley has been in public discourse in recent years regarding a myriad of things. There is the fact that Elvis built his career off of music and songs from Black singers like Big Mama Thornton in the titular song “Hound Dog.” There is also a considerat…	\s
Lana Del Rey Didn't Realize You Have to Submit Music to Be Considered for the Grammys	Lana Del Rey is reacting to her five Grammy nominations! On Friday (November 10), the 38-year-old singer received nods in major categories including Album of the Year and Song of the Year. Lana, who hasn’t won a Grammy yet, learned about the process of submit…	\s
'The Marvels' melts down at the box office, marking a new low for the MCU	Since 2008's ''Iron Man,'' the Marvel machine has been one of the most unstoppable forces in box-office history. Now, though, that aura of invincibility is showing signs of wear and tear. The superhero factory hit a new low with the weekend launch of ''The Ma…	\s
The Ballad Of Songbirds And Snakes Director Will Make Another Hunger Games Under One Condition	Director Francis Lawrence is game to make another Hunger Games film after Ballad of Snakes and Songbirds, but only if Suzanne Collins writes a new novel first.	\s
Priscilla: Lana Del Ray almost featured on movie's soundtrack, says Sofia Coppola	Lana Del Ray has been an ardent fan of Elvis Presley and Priscilla. The singer was about to be part of the movie but conflicting schedules came in the way. Although Coppola extended an invitation to the Grammy-nominated artist for the film's premiere, Lana De…	\s
Emerald Fennell Says Saltburn Is About the “Absurdity of Class”	As her twisty, erotic thriller about the unfairness of wealth and class comes out, Emerald Fennell talks about “awfully rich people behaving awfully”	\s
Eli Roth gets back to the bloody basics with Thanksgiving	There’s a correct method to jamming two corncob holders into a teenager’s ears for maximum terror. Eli Roth has known the way since he was a kid in Massachusetts, shooting horror movies in his backyard and coming up with kills that would eventually find their…	\s
Box Office Predictions: The Marvels looks to have one of the worst MCU debuts	With many fans growing tired of the MCU formula, The Marvels looks to have a debut in the bottom three of all 33 films.
The post Box Office Predictions: The Marvels looks to have one of the worst MCU debuts appeared first on JoBlo.	\s
Rachel Zegler’s New Movie Becomes Worst-Rated in Franchise History	Ahead of her Disney debut in director Marc Webb’s Snow White (2025) reboot, lead actress Rachel Zegler is gearing up for the premiere of her latest outing, The Hunger Games: The Ballad of Songbirds and Snakes (2023). The movie, which serves as a prequel to th…	\s
Lisa Marie Presley Denounced Priscilla Before Her Death	Lisa Marie Presley Denounced Priscilla Before Her Death - Here's Why The art of crafting a biopic that tells the truth about its subject matter and pleases both their fans and their estate alike is an often difficult prospect. To wit: while Sofia Coppola's "P…	\s
Stephen King Has A Theory About Why The Marvels Is Not Doing Great At The Box Office	Author and "Mambo No. 5" superfan Stephen King has weighed in on the recent struggles of The Marvels at the box office, saying the poor opening-weekend results may be due, in part, to "adolescent fanboy hate."Posting on X (formerly Twitter), King said he does…	\s
Alexander Payne Talks ‘The Holdovers,’ Paul Giamatti Being The “Greatest Actor” And Teases Future Western & French Language Projects	Born in Omaha, Nebraska, to two parents of Greek heritage, two-time Oscar winner Alexander Payne was awarded Greek citizenship last year around the time he was working on his latest feature, The Holdovers. In line with the honor, Payne has returned to his ado…	\s
Meet 'Saltburn' Hotties Jacob Elordi, Barry Keoghan & Archie Madekwe	These guys are obsessed with each other in Saltburn.	\s
‘Election’ Sequel: Alexander Payne Says He Wants Matthew Broderick Back & To “Loosely” Adapt The Book That Doesn’t Include His Character	As you probably have heard by now, writer Tom Perrota, the author of 1998’s novel “Election,” which was adapted into a very successful feature film by filmmaker Alexander Payne, has written the sequel, 2022’s book “Tracy Flick Can’t Win.” And some years back,…	\s
Movie Kubrick never made...	Ridley Scott interview about Napoleon, his relationship with Stanley Kubrick and William Friedkin, and telling a story Kubrick never could.	\s
Sofia Coppola Hoped to Get Lana Del Rey for ‘Priscilla’ Soundtrack	Coppola also invited Del Rey to the premiere, but the singer-songwriter couldn’t attend.	\s
Jacob Elordi Says He Ate a Pound of Bacon Every Day to Prepare to Play Elvis Presley in "Priscilla"	The actor revealed that he was “the biggest” he's ever been while trying to eat The King's infamously bad diet.	\s
There Are REAL CELEBS at the Saltburn Premiere	MARGOT ROBBIE, HOW I'VE MISSED YE.
The post There Are REAL CELEBS at the Saltburn Premiere first appeared on Go Fug Yourself.	\s
The week in film: Thanksgiving's gory feast, and what's wrong with Marvel	Horror fans have been waiting more than a decade for Thanksgiving, director Eli Roth’s holiday slasher about a killer in a pilgrim mask terrorizing a small Massachusetts town. Ever since Roth’s fake trailer for the film showed up in Quentin Tarantino and Robe…	\s
‘Thanksgiving’ Director Eli Roth on Creative Kills and His Surprisingly Chummy Relationship With the Ratings Board	Eli Roth is back. And he’s here for “Thanksgiving.” For the past decade, Roth has nimbly moved through different genres – erotic thriller (“Knock Knock”), revenge movie (“Death Wish”), family fantasy (“The House with a Clock in Its Walls”), nature documentary…	\s
SALTBURN Los Angeles Premiere Red Carpet Rundown	The cast and director of Saltburn came out in style for the LA premiere and once again, we must take a moment to savor the return of premiere red carpets to our lives. Also, if you’re looking for Saltburn fangirl Margot Robbie’s appearance, it’s right here. N…	\s
MOVIES: A sweet one for the holidays, Denys Arcand on our woke conflicts and a new one from Marvel	Also: extreme pursuit of fame and re-imagining your life in high school	\s
Holiday slasher ‘Thanksgiving’ serves up killer spread	As an ax-wielding psycho in a mask stalks Plymouth with shall we say pointed references to its very first Thanksgiving, the body count continues to mount, all executed in increasingly disturbing ways.	\s
Thanksgiving 2: Is It Happening? Everything We Know	Eli Roth's holiday horror splatter flick Thanksgiving brings terror to Turkey Day, but will there be a sequel in the burgeoning slasher franchise?	\s
Saltburn Is All Vibes and Empty Provocations	‘Saltburn,’ the second film from ‘Promising Young Woman’’s Emerald Fennell, is all vibes and empty provocations.	\s
Thanksgiving review: Eli Roth serves up a gory feast	Horror fans have been waiting more than a decade for Thanksgiving, director Eli Roth’s holiday slasher about a killer in a pilgrim mask terrorizing a small Massachusetts town. Ever since Roth’s fake trailer for the film showed up in Quentin Tarantino and Robe…	\s
Jacob Elordi Copied Elvis' Out Of Control Bacon Habit For 'Priscilla'	Elordi said he was eating a pound of bacon a day while playing The King in Sofia Coppola's new film.	\s
‘The Hunger Games’ Star Rachel Zegler Recalls Meeting Jennifer Lawrence Jokingly Wanting To Strangle Her For Photo	Rachel Zegler stars in The Hunger Games: The Ballad of Songbirds & Snakes and recently recalled an encounter she had with OG star Jennifer Lawrence. While making an appearance on The Kelly Clarkson Show, Zegler opened up about meeting Lawrence during the Chri…	\s
New and Noteworthy: November 2023	The time change comes at the beginning of every November and yet I still struggle with it every year. As soon as it gets dark at 5:00pm, I find it so hard to work and be productive since it feels like 8:00pm. I also have a trip to Paris coming up so there is …	\s
The Hunger Games: The Ballad of Songbirds and Snakes (2023)	Genres: Action and Adventure 
Running Time: 158 min. 
Directed by: Francis Lawrence 
Starring: Rachel Zegler, Tom Blyth 
Synopsis: Coriolanus Snow mentors and develops feelings for the female District 12 tribute during the 10th Hunger Games.	\s
Did Priscilla Presley Ever Remarry After Her Divorce From Elvis?	Getty Image

The businesswoman and actress is the focus of the latest Sofia Coppola film, which concerns her marriage to Elvis Presley.	\s
